4 13 31
###############################
#                 w           #
#                             #
# w             w w  ww    w  #
#  w     w     w  w  w w   w  #
#   w   w w   w   w  w  w  w  #
#    w w   w w    w  w   w w  #
#     w     w     w  w    ww  #
#                             #
#                             #
#              p              #
#                             #
###############################