2 13 31
###############################
#p   ** **    *   2 # #       #
# # # #*# # # # # # # # # # # #
#*     ** * *  *   * ** 3 *   #
# # # # # #*# # # # # # #*# # #
#* 2 *s*    *** * x **        #
# # # # # # # # # # # # # #*# #
#    *     *        *    **   #
# #*# # #*#*#*#*# # #1# # #*# #
#    2   *   *2*    *   *     #
#*# # # # # # # # # # #*# # #*#
# *    * **    ** ***     1   #
###############################