3 13 31
###############################
#p   ** **    *   2 # #       #
#*#*#***# # # # # # # # # # # #
#*123   * * *  *   * ** 3 *   #
#*      # #*# # # # # # #*# # #
#*#*#bsf#   *** * x **        #
#*# # # # # # # # # # # # #*# #
#    *     *        *    **   #
# #*# # #*#*#*#*# # #1# # #*# #
#    2   *   *2*    *   *     #
#*# # # # # # # # # # #*# # #*#
# *    * **    ** ***     1   #
###############################