4 13 31
###############################
#                             #
# f             f f  ff    f  #
#  f     f     f  f  f f   f  #
#   f   f f   f   f  f  f  f  #
#    f f   f f    f  f   f f  #
#     f     f     f  f    ff  #
#                             #
#                             #
#             p               #
#                             #
#                             #
###############################