2 13 31
###############################
#p   sf fb    *   2 # #       #
#b# # #b# # # # # # # # # # # #
#*     ** * *  *   * ** 3 *   #
# # # # # #*# # # # # # #*# # #
#* 2 ***    *** * x **        #
# # # # # # # # # # # # # #*# #
#    *     *        *    **   #
# #*# # #*#*#*#*# # #1# # #*# #
#    2   *   *2*    *   *     #
#*# # # # # # # # # # #x# # #*#
# *    * **    ** ***     1   #
###############################